                     AbstractPipe: (abstract)
            AbstractRecordHandler: (abstract)
            AbstractResultHandler: (abstract)
             AbstractXmlValidator: (abstract)
                          Adapter: Adapter
                    AdapterFilter: Adapterfilter
                    Adios2XmlPipe: Adios2XmlPipe
                Afm2EdiFactSender: Afm2EdiFactErrorSender, Afm2EdiFactSender
                            Alarm: AlarmTrigger
                   AmazonS3Sender: AmazonS3ErrorSender, AmazonS3Sender
                AmountOfPagesPipe: AmountOfPagesPipe
                      ApiListener: ApiListener
                 ApiPrincipalPipe: ApiPrincipalPipe
               ApiSoapWrapperPipe: ApiSoapInputWrapper, ApiSoapOutputWrapper, ApiSoapWrapperPipe
                    ApiStreamPipe: ApiStreamPipe
              ApiWsdlXmlValidator: ApiWsdlXmlInputValidator, ApiWsdlXmlOutputValidator, ApiWsdlXmlValidatorPipe
                       Base64Pipe: Base64Pipe
         BatchBlobTransformerPipe: BatchBlobTransformerPipe
         BatchClobTransformerPipe: BatchClobTransformerPipe
         BatchFileTransformerPipe: BatchFileTransformerPipe
         BatchTransformerPipeBase: (abstract)
                   BisJmsListener: BisJmsListener
                     BisJmsSender: BisJmsErrorSender, BisJmsSender
                   BisWrapperPipe: BisInputWrapper, BisOutputWrapper, BisWrapperPipe
            BlobLineIteratingPipe: BlobLineIteratingPipe
                  BytesOutputPipe: BytesOutputPipe
                 CacheAdapterBase: (abstract)
                   CheckReloadJob: CheckReloadJob
                     ChecksumPipe: ChecksumPipe
               CleanupDatabaseJob: CleanupDatabaseJob
             CleanupFileSystemJob: CleanupFileSystemJob
                         Clearing: ClearingTrigger
            ClobLineIteratingPipe: ClobLineIteratingPipe
                CmisEventListener: CmisEventListener
                       CmisSender: CmisErrorSender, CmisSender
                CollectorPipeBase: (abstract)
              CollectorSenderBase: (abstract)
                    CommandSender: CommandErrorSender, CommandSender
               CompareIntegerPipe: CompareIntegerPipe
                CompareStringPipe: CompareStringPipe
                     CompressPipe: CompressPipe
         ConfigurableLifecyleBase: (abstract)
                    Configuration: Configuration
                CounterSwitchPipe: CounterSwitchPipe
           CredentialCheckingPipe: CredentialCheckingPipe
                          CrlPipe: CrlPipe
                    CsvParserPipe: CsvParserPipe
                        DelayPipe: DelayPipe
                      DelaySender: DelayErrorSender, DelaySender
  DelphiStringRecordReaderFactory: DelphiStringRecordReaderFactory
                DirectQuerySender: DirectQueryErrorSender, DirectQuerySender
                DirectWrapperPipe: DirectWrapperPipe
                 DirectoryCleaner: DirectoryCleaner
                DirectoryListener: DirectoryListener
            DomainTransformerPipe: DomainTransformerPipe
        DummyTransactionalStorage: DummyErrorStorage, DummyMessageLog
                         EchoPipe: EchoPipe
                       EchoSender: EchoErrorSender, EchoSender
                          EhCache: EhCache
            ErrorMessageFormatter: ErrorMessageFormatter
                   EsbJmsListener: EsbJmsListener
                     EsbJmsSender: EsbJmsErrorSender, EsbJmsSender
       EsbJmsTransactionalStorage: EsbJmsErrorStorage, EsbJmsMessageLog
                 EsbSoapValidator: EsbSoapInputValidator, EsbSoapOutputValidator, EsbSoapValidatorPipe
               EsbSoapWrapperPipe: EsbSoapInputWrapper, EsbSoapOutputWrapper, EsbSoapWrapperPipe
                       EscapePipe: EscapePipe
                  EtagHandlerPipe: EtagHandlerPipe
                    ExceptionPipe: ExceptionPipe
             ExchangeFolderSender: ExchangeFolderErrorSender, ExchangeFolderSender
             ExchangeMailListener: ExchangeMailListener
                  ExecuteQueryJob: ExecuteQueryJob
FieldPositionRecordHandlerManager: FieldPositionChild, FieldPositionManager
                      FileHandler: 
             FileLineIteratorPipe: FileLineIteratorPipe
                         FilePipe: FilePipe
               FileRecordListener: FileRecordListener
                       FileSender: FileErrorSender, FileSender
               FileSystemListener: (abstract)
                   FileSystemPipe: (abstract)
                 FileSystemSender: (abstract)
  FileSystemSenderWithAttachments: FileSystemSenderWithAttachmentsErrorSender, FileSystemSenderWithAttachmentsSender
                   FilenameSwitch: FilenameSwitchPipe
                FixedErrorMessage: FixedErrorMessageErrorMessageFormatter
       FixedErrorMessageFormatter: FixedErrorMessageFormatter
                 FixedForwardPipe: (abstract)
FixedPositionRecordHandlerManager: FixedPositionChild, FixedPositionManager
                 FixedQuerySender: FixedQueryErrorSender, FixedQuerySender
                      FixedResult: 
                  FixedResultPipe: FixedResultPipe
                FixedResultSender: FixedResultErrorSender, FixedResultSender
            ForEachAttachmentPipe: ForEachAttachmentPipe
          ForEachChildElementPipe: ForEachChildElementPipe
            FtpFileSystemListener: FtpFileSystemListener
              FtpFileSystemSender: FtpFileSystemErrorSender, FtpFileSystemSender
                      FxfListener: FxfListener
                   FxfWrapperPipe: FxfInputWrapper, FxfOutputWrapper, FxfWrapperPipe
                  FxfXmlValidator: FxfXmlInputValidator, FxfXmlOutputValidator, FxfXmlValidatorPipe
                   GetFromSession: GetFromSessionPipe
                 GetPrincipalPipe: GetPrincipalPipe
                   GetTibcoQueues: GetTibcoQueuesPipe
                   GlobalListItem: 
                         HashPipe: HashPipe
                     HttpListener: HttpListener
                       HttpSender: HttpErrorSender, HttpSender
                   HttpSenderBase: (abstract)
                      HttpSession: HttpSession, HttpSessionSharedResource
                  HttpSessionBase: (abstract)
                        IMSSender: IMSErrorSender, IMSSender
                    IbisActionJob: IbisActionJob
                   IbisJavaSender: IbisJavaErrorSender, IbisJavaSender
                  IbisLocalSender: IbisLocalErrorSender, IbisLocalSender
                       IdinSender: IdinErrorSender, IdinSender
           IdocSender (from jco3): 
            IdocSender (from sap): IdocErrorSender, IdocSender
                   IdocSenderImpl: (abstract)
                      IfMultipart: IfMultipartPipe
                     ImapListener: ImapListener
                       ImapSender: ImapErrorSender, ImapSender
                          Include: Include
              IncreaseIntegerPipe: IncreaseIntegerPipe
         InputStreamReaderFactory: InputStreamReaderFactory
                  InputfieldsPart: InputFields
                 IsUserInRolePipe: IsUserInRolePipe
                        IsXmlPipe: IsXmlPipe
                    IteratingPipe: (abstract)
                        JMSFacade: 
                     JavaListener: JavaListener
                 JavascriptSender: JavascriptErrorSender, JavascriptSender
                       JdbcFacade: 
            JdbcIteratingPipeBase: (abstract)
                     JdbcListener: JdbcListener
               JdbcMessageBrowser: (abstract)
                JdbcQueryListener: JdbcQueryListener
              JdbcQuerySenderBase: (abstract)
                   JdbcSenderBase: (abstract)
                JdbcTableListener: JdbcTableListener
          JdbcTableMessageBrowser: 
         JdbcTransactionalStorage: JdbcErrorStorage, JdbcMessageLog
                      JmsListener: JmsListener
                  JmsListenerBase: (abstract)
                JmsMessageBrowser: (abstract)
                         JmsRealm: JmsRealm
                  JmsRealmFactory: JmsRealms
                        JmsSender: JmsErrorSender, JmsSender
          JmsTransactionalStorage: JmsErrorStorage, JmsMessageLog
                         JndiBase: 
                              Job: Job
                           JobDef: (abstract)
                Json2XmlValidator: Json2XmlInputValidator, Json2XmlOutputValidator, Json2XmlValidatorPipe
                         JsonPipe: JsonPipe
                    JsonValidator: JsonInputValidator, JsonOutputValidator, JsonValidatorPipe
            JsonWellFormedChecker: JsonWellFormedCheckerPipe
                     JsonXsltPipe: JsonXsltPipe
                   JsonXsltSender: JsonXsltErrorSender, JsonXsltSender
                          JwtPipe: JwtPipe
                      KafkaFacade: (abstract)
                    KafkaListener: KafkaListener
                      KafkaSender: KafkaErrorSender, KafkaSender
                      LabelFormat: LabelFormatPipe
                      LadybugPipe: LadybugPipe
                        LarvaPipe: LarvaPipe
                LdapChallengePipe: LdapChallengePipe
     LdapFindGroupMembershipsPipe: LdapFindGroupMembershipsPipe
               LdapFindMemberPipe: LdapFindMemberPipe
                LdapQueryPipeBase: (abstract)
                       LdapSender: LdapErrorSender, LdapSender
         LoadDatabaseSchedulesJob: LoadDatabaseSchedulesJob
         LobLineIteratingPipeBase: (abstract)
              LocalFileSystemPipe: LocalFileSystemPipe
            LocalFileSystemSender: LocalFileSystemErrorSender, LocalFileSystemSender
                           Locker: Locker
                   LogContextPipe: LogContextPipe
                        LogSender: LogErrorSender, LogSender
                         MQSender: MQErrorSender, MQSender
                     MailListener: (abstract)
                       MailSender: MailErrorSender, MailSender
                   MailSenderBase: (abstract)
                   MailSenderPipe: MailSenderPipe
               MessageSendingPipe: 
             MessageStoreListener: MessageStoreListener
               MessageStoreSender: MessageStoreErrorSender, MessageStoreSender
                    MongoDbSender: MongoDbErrorSender, MongoDbSender
                          Monitor: Monitor
           MonitorDestinationBase: (abstract)
                   MonitorManager: Monitoring
                     MoveFilePipe: MoveFilePipe
                       MqttFacade: 
                     MqttListener: MqttListener
                       MqttSender: MqttErrorSender, MqttSender
              MultipartHttpSender: MultipartHttpErrorSender, MultipartHttpSender
                 NetStorageSender: NetStorageErrorSender, NetStorageSender
                    ObfuscatePipe: ObfuscatePipe
                 OutputfieldsPart: OutputFields
                          PGPPipe: PGPPipe
                  ParallelSenders: ParallelSendersErrorSender, ParallelSendersSender
                        Parameter: Param
            PasswordGeneratorPipe: PasswordGeneratorPipe
                 PasswordHashPipe: PasswordHashPipe
                          PdfPipe: PdfPipe
                      PipeForward: Forward
                     PipeForwards: GlobalForwards
                         PipeLine: Pipeline
                     PipeLineExit: Exit
                    PipeLineExits: Exits
             PostboxRetrieverPipe: PostboxRetrieverPipe
               PullingJmsListener: PullingJmsListener
               PushingJmsListener: PushingJmsListener
           PushingListenerAdapter: (abstract)
                     PutInSession: PutInSessionPipe
           PutParametersInSession: PutParametersInSessionPipe
           PutSystemDateInSession: PutSystemDateInSessionPipe
                         Receiver: Receiver
           ReconnectSenderWrapper: ReconnectSenderWrapperErrorSender, ReconnectSenderWrapperSender
             RecordHandlerManager: Manager
               RecordHandlingFlow: Flow
                RecordTransformer: RecordTransformerChild, RecordTransformerRecordHandler
                 RecordXml2Sender: RecordXml2SenderChild, RecordXml2SenderRecordHandler
             RecordXmlTransformer: RecordXmlTransformerChild, RecordXmlTransformerRecordHandler
               RecoverAdaptersJob: RecoverAdaptersJob
                   RekenBoxCaller: RekenBoxCallerPipe
                     ReloadSender: ReloadErrorSender, ReloadSender
               RemoveCacheKeyPipe: RemoveCacheKeyPipe
                RemoveFromSession: RemoveFromSessionPipe
                     ReplacerPipe: ReplacerPipe
                     RestListener: RestListener
                       RestSender: RestErrorSender, RestSender
                Result2BlobWriter: Result2BlobWriterChild, Result2BlobWriterResultHandler
                Result2ClobWriter: Result2ClobWriterChild, Result2ClobWriterResultHandler
                Result2Filewriter: Result2FilewriterChild, Result2FilewriterResultHandler
             Result2LobWriterBase: (abstract)
              Result2StringWriter: Result2StringWriterChild, Result2StringWriterResultHandler
               ResultBlock2Sender: ResultBlock2SenderChild, ResultBlock2SenderResultHandler
             ResultSet2FileSender: ResultSet2FileErrorSender, ResultSet2FileSender
           ResultSetIteratingPipe: ResultSetIteratingPipe
                     ResultWriter: (abstract)
                       Samba1Pipe: Samba1Pipe
                     Samba1Sender: Samba1ErrorSender, Samba1Sender
                   Samba2Listener: Samba2Listener
                       Samba2Pipe: Samba2Pipe
                     Samba2Sender: Samba2ErrorSender, Samba2Sender
                    SambaListener: SambaListener
                        SambaPipe: SambaPipe
                SapFunctionFacade: (abstract)
                    SapLUWManager: SapLUWManagerPipe
          SapListener (from jco3): 
           SapListener (from sap): SapListener
                  SapListenerImpl: (abstract)
            SapSender (from jco3): 
             SapSender (from sap): SapErrorSender, SapSender
                    SapSenderBase: (abstract)
                    SapSenderImpl: (abstract)
            SapSystem (from jco3): 
             SapSystem (from sap): SapSystem
                    SapSystemImpl: (abstract)
                       SapSystems: SapSystems
            ScanTibcoSolutionPipe: ScanTibcoSolutionPipe
                  ScheduleManager: Scheduler
                  SchedulerSender: SchedulerErrorSender, SchedulerSender
                   SendGridSender: SendGridErrorSender, SendGridSender
                   SendMessageJob: SendMessageJob
                 SendTibcoMessage: SendTibcoMessagePipe
                       SenderBase: (abstract)
             SenderMonitorAdapter: SenderMonitorAdapterDestination
                       SenderPipe: SenderPipe
                     SenderSeries: SenderSeriesErrorSender, SenderSeriesSender
         SenderWithParametersBase: (abstract)
                    SenderWrapper: SenderWrapperErrorSender, SenderWrapperSender
                SenderWrapperBase: (abstract)
           SftpFileSystemListener: SftpFileSystemListener
             SftpFileSystemSender: SftpFileSystemErrorSender, SftpFileSystemSender
                     ShadowSender: ShadowErrorSender, ShadowSender
                  SharedResources: SharedResources
                    SignaturePipe: SignaturePipe
               SimpleJdbcListener: SimpleJdbcListener
                         SizePipe: SizePipe
                         SkipPipe: SkipPipe
                 SoapErrorMessage: SoapErrorMessageErrorMessageFormatter
        SoapErrorMessageFormatter: SoapErrorMessageFormatter
                    SoapValidator: SoapInputValidator, SoapOutputValidator, SoapValidatorPipe
                  SoapWrapperPipe: SoapInputWrapper, SoapOutputWrapper, SoapWrapperPipe
       StoredProcedureQuerySender: StoredProcedureQueryErrorSender, StoredProcedureQuerySender
                Stream2StringPipe: Stream2StringPipe
           StreamLineIteratorPipe: StreamLineIteratorPipe
                       StreamPipe: StreamPipe
            StreamTransformerPipe: StreamTransformerPipe
               StringIteratorPipe: (abstract)
                     Text2XmlPipe: Text2XmlPipe
                 TextSplitterPipe: TextSplitterPipe
              TibcoLogJmsListener: TibcoLogJmsListener
                 TimeoutGuardPipe: (abstract)
            TransactionAttributes: 
                          Trigger: Trigger
                UUIDGeneratorPipe: UUIDGeneratorPipe
                        UnzipPipe: UnzipPipe
                    ValidatorBase: (abstract)
               WebServiceListener: WebServiceListener
             WebServiceNtlmSender: WebServiceNtlmErrorSender, WebServiceNtlmSender
                 WebServiceSender: WebServiceErrorSender, WebServiceSender
                WsdlGeneratorPipe: WsdlGeneratorPipe
                 WsdlXmlValidator: WsdlXmlInputValidator, WsdlXmlOutputValidator, WsdlXmlValidatorPipe
                       XComSender: XComErrorSender, XComSender
                       XQueryPipe: XQueryPipe
               XercesXmlValidator: 
                        XfbSender: XfbErrorSender, XfbSender
                   XmlBuilderPipe: XmlBuilderPipe
       XmlFileElementIteratorPipe: XmlFileElementIteratorPipe
                            XmlIf: XmlIfPipe
              XmlJmsBrowserSender: XmlJmsBrowserErrorSender, XmlJmsBrowserSender
                   XmlQuerySender: XmlQueryErrorSender, XmlQuerySender
                        XmlSwitch: XmlSwitchPipe
                     XmlValidator: XmlInputValidator, XmlOutputValidator, XmlValidatorPipe
               XmlValidatorSender: XmlValidatorErrorSender, XmlValidatorSender
             XmlWellFormedChecker: XmlWellFormedCheckerInputValidator, XmlWellFormedCheckerOutputValidator, XmlWellFormedCheckerPipe
         XslErrorMessageFormatter: XslErrorMessageFormatter
                         XsltPipe: XsltPipe
                       XsltSender: XsltErrorSender, XsltSender
         Y01ErrorMessageFormatter: Y01ErrorMessageFormatter
                  ZipIteratorPipe: ZipIteratorPipe
                    ZipWriterPipe: ZipWriterPipe
                  ZipWriterSender: ZipWriterErrorSender, ZipWriterSender
